##name	300-ru-en
##sourceLang	Russian
##targetLang	English
Белл|Белла|Беллам|Беллами|Беллах|Белле|Беллов|Беллом|Беллу|Беллы	<font color="#007000">noun</font> Белл (m) <br>\nAlexander Graham Bell, American scientist who invented the telephone
Гвендолин|Гвендолина|Гвендолинам|Гвендолинами|Гвендолинах|Гвендолине|Гвендолинов|Гвендолином|Гвендолину|Гвендолины	<font color="#007000">noun</font> Гвендолин (f) <br>\nGwendolyn
Ирина|Ирин|Иринe|Иринам|Иринами|Иринах|Ирине|Ириной|Ириною|Ирину|Ирины	<font color="#007000">noun</font> Ирина (f) <br>\nIrene, female first name
Осмунд|Осмунда|Осмундам|Осмундами|Осмундах|Осмунде|Осмундов|Осмундом|Осмунду|Осмунды	<font color="#007000">noun</font> Осмунд (f) <br>\nOsmond, male first name
Турция|Турцией|Турциею|Турции|Турций|Турцию|Турциям|Турциями|Турциях	<font color="#007000">noun</font> Турция (f) <br>\nTurkey, country in western Asia and southeastern Europe between the Mediterranean Sea and the Black Sea
Уилли	<font color="#007000">noun</font> Уилли (m) <br>\nWilly, male first name (form of William)
абракадабра|абракадабр|абракадабрe|абракадабрам|абракадабрами|абракадабрах|абракадабре|абракадаброй|абракадаброю|абракадабру|абракадабры	<font color="#007000">noun</font> абракадабра (f) <br>\nabracadabra, word used when performing a magic trick
альтруист|альтруиста|альтруистам|альтруистами|альтруистах|альтруисте|альтруистка|альтруисткам|альтруистками|альтруистках|альтруистке|альтруистки|альтруисткой|альтруистку|альтруистов|альтруисток|альтруистом|альтруисту|альтруисты	<font color="#007000">noun</font> альтруист (m) <br>\naltruist, one unselfishly devoted to others, philanthropist
анонимка|анонимкe|анонимкам|анонимками|анонимках|анонимке|анонимки|анонимкой|анонимкою|анонимку|анонимок	<font color="#007000">noun</font> анонимка (f) <br>\nanonymous letter, unsigned letter
антилопа канна	<font color="#007000">noun</font><br>\neland
аптека|аптек|аптекe|аптекам|аптеками|аптеках|аптеке|аптеки|аптекой|аптекою|аптеку	<font color="#007000">noun</font> аптека (f) <br>\npharmacy, drugstore, dispensary, apothecary
батончик|батончика|батончикам|батончиками|батончиках|батончике|батончики|батончиков|батончиком|батончику	<font color="#007000">noun</font> батончик (m) <br>\nstick of confectionery
без дождя|без дождь	<font color="#007000">adjective</font><br>\nrainless
безголосый(transitive)|безголос|безголоса|безголосо|безголосы	<font color="#007000">adjective</font> безголосый<br>\nvoiceless
безносый(transitive)|безнос|безноса|безносо|безносы	<font color="#007000">adjective</font> безносый<br>\nnoseless
белеть(transitive)|белев|белевшая|белевшего|белевшее|белевшей|белевшем|белевшему|белевши|белевшие|белевший|белевшим|белевшими|белевших|белевшую|белеющая|белеющего|белеющее|белеющей|белеющем|белеющему|белеющие|белеющий|белеющим|белеющими|белеющих|белеющую|белея|забелев|забелевшая|забелевшаяся|забелевшего|забелевшегося|забелевшее|забелевшееся|забелевшей|забелевшейся|забелевшем|забелевшемся|забелевшему|забелевшемуся|забелевши|забелевшие|забелевшиеся|забелевший|забелевшийся|забелевшим|забелевшими|забелевшимися|забелевшимся|забелевшись|забелевших|забелевшихся|забелевшую|забелевшуюся	<font color="#007000">verb</font> белеть<br>\n<I>(also:<B>забелеть,забелеться</B>)</I> blanch, whiten; show white, go grey
бескомпромиссный|бескомпромиссная|бескомпромиссного|бескомпромиссное|бескомпромиссной|бескомпромиссном|бескомпромиссному|бескомпромиссную|бескомпромиссные|бескомпромиссным|бескомпромиссными|бескомпромиссных	<font color="#007000">adjective</font><br>\nuncompromising, intransigent, unyielding; hard core, straight-out
бледноватый(transitive)|бледноват|бледновата|бледновато|бледноваты	<font color="#007000">adjective</font> бледноватый<br>\npalish
блокнот|блокнота|блокнотам|блокнотами|блокнотах|блокноте|блокнотов|блокнотом|блокноту|блокноты	<font color="#007000">noun</font> блокнот (m) <br>\nnote book, writing pad, scratchpad, tablet, jotter
бодрить(transitive)|бодрив|бодрившая|бодрившего|бодрившее|бодрившей|бодрившем|бодрившему|бодривши|бодрившие|бодривший|бодрившим|бодрившими|бодривших|бодрившую|бодря|бодрящая|бодрящего|бодрящее|бодрящей|бодрящем|бодрящему|бодрящие|бодрящий|бодрящим|бодрящими|бодрящих|бодрящую	<font color="#007000">verb</font> бодрить<br>\ninvigorate, energize
бульварная пресса|бульварный пресса	<font color="#007000">noun</font><br>\ngutter press, tabloid press
быть деятельным|быть деятельный	be on one's toes
быть знатного рода|быть знатный род	be born in the purple
в отъезде|в отъезд	<font color="#007000">adverb</font><br>\nout of town
в разгаре|в разгар	<font color="#007000">adverb</font><br>\nin high gear, afloat, in full play
валиться|валилась|валились|валилось|валился|валимся|вались|валитесь|валится|валишься|валюсь|валятся	<font color="#007000">verb</font><br>\nfall, topple, fell; flake out, fold up
вальцевать|вальцевал|вальцевала|вальцевали|вальцевало|вальцуем|вальцует|вальцуете|вальцуешь|вальцуй|вальцуйте|вальцую|вальцуют	<font color="#007000">verb</font><br>\nroll
вафельный|вафельная|вафельного|вафельное|вафельной|вафельном|вафельному|вафельную|вафельные|вафельным|вафельными|вафельных	<font color="#007000">adjective</font><br>\nwaffle
вердикт|вердикта|вердиктам|вердиктами|вердиктах|вердикте|вердиктов|вердиктом|вердикту|вердикты	<font color="#007000">noun</font> вердикт (m) <br>\nverdict; deliverance
взмыть|взмоем|взмоет|взмоете|взмоешь|взмой|взмойте|взмою|взмоют|взмыл|взмыла|взмыли|взмыло	<font color="#007000">verb</font><br>\nzoom, rise suddenly
во цвете лет|в цвет лет	<font color="#007000">adjective</font><br>\nin the flower of one's age
возрастать(transitive)|возрастав|возраставшая|возраставшего|возраставшее|возраставшей|возраставшем|возраставшему|возраставши|возраставшие|возраставший|возраставшим|возраставшими|возраставших|возраставшую|возрастающая|возрастающего|возрастающее|возрастающей|возрастающем|возрастающему|возрастающие|возрастающий|возрастающим|возрастающими|возрастающих|возрастающую|возрастая	<font color="#007000">verb</font> возрастать<br>\nincrease, rise; redouble
воскресать|воскрес|воскресаем|воскресает|воскресаете|воскресаешь|воскресай|воскресайте|воскресал|воскресала|воскресали|воскресало|воскресаю|воскресают|воскресла|воскресли|воскресло|воскреснем|воскреснет|воскреснете|воскреснешь|воскресни|воскресните|воскресну|воскреснул|воскреснула|воскреснули|воскреснуло|воскреснут|воскреснуть	<font color="#007000">verb</font><br>\n<I>(perf. ><B>воскреснуть</B>)</I> resurrect; revive, resuscitate; arise, rise
всенощная|всенощной|всенощную|всенощные|всенощным|всенощными|всенощных	<font color="#007000">noun</font> всенощная (f) <br>\nvigil, time of prayer on the eve of a religious holiday; vespers, evening prayer service (Christianity)
вскочить(transitive)|вскочив|вскочившая|вскочившего|вскочившее|вскочившей|вскочившем|вскочившему|вскочивши|вскочившие|вскочивший|вскочившим|вскочившими|вскочивших|вскочившую	<font color="#007000">verb</font> вскочить<br>\njump into; jump on, jump upon; jump, start up
втягивающийся|втягивающаяся|втягивающегося|втягивающееся|втягивающейся|втягивающемся|втягивающемуся|втягивающиеся|втягивающимися|втягивающимся|втягивающихся|втягивающуюся	<font color="#007000">adjective</font><br>\nretractable
выкрашенный в пряже|выкрашенный в пряжа	<font color="#007000">adjective</font><br>\ndyed in the wool
выкручиваться(transitive)|выкрутившаяся|выкрутившегося|выкрутившееся|выкрутившейся|выкрутившемся|выкрутившемуся|выкрутившиеся|выкрутившийся|выкрутившимися|выкрутившимся|выкрутившись|выкрутившихся|выкрутившуюся|выкручивавшаяся|выкручивавшегося|выкручивавшееся|выкручивавшейся|выкручивавшемся|выкручивавшемуся|выкручивавшиеся|выкручивавшийся|выкручивавшимися|выкручивавшимся|выкручивавшись|выкручивавшихся|выкручивавшуюся|выкручивающаяся|выкручивающегося|выкручивающееся|выкручивающейся|выкручивающемся|выкручивающемуся|выкручивающиеся|выкручивающийся|выкручивающимися|выкручивающимся|выкручивающихся|выкручивающуюся|выкручиваясь	<font color="#007000">verb</font> выкручиваться<br>\n<I>(perf. ><B>выкрутиться</B>)</I> slip out; come unscrewed
выложить все	empty the bag
газель антидорка	<font color="#007000">noun</font><br>\nspringbok, springer
гальванизированный|гальванизированная|гальванизированного|гальванизированное|гальванизированной|гальванизированном|гальванизированному|гальванизированную|гальванизированные|гальванизированным|гальванизированными|гальванизированных	<font color="#007000">adjective</font><br>\ngalvanized
галька|галек|галькe|галькам|гальками|гальках|гальке|гальки|галькой|галькою|гальку	<font color="#007000">noun</font> галька (f) <br>\npebble, shingle
гибко	<font color="#007000">adverb</font><br>\npliably, flexibly; yieldingly, compliantly; supply
гиппопотам|гиппопотама|гиппопотамам|гиппопотамами|гиппопотамах|гиппопотаме|гиппопотамов|гиппопотамом|гиппопотаму|гиппопотамы	<font color="#007000">noun</font> гиппопотам (m) <br>\nhippopotamus, hippo
глист|глиста|глистам|глистами|глистах|глисте|глистов|глистом|глисту|глисты	<font color="#007000">noun</font> глист (m) <br>\nworm, helminth
глупеть|глупеем|глупеет|глупеете|глупеешь|глупей|глупейте|глупел|глупела|глупели|глупело|глупею|глупеют	<font color="#007000">verb</font><br>\ngrow stupid
голословный(transitive)|голословен|голословна|голословно|голословны	<font color="#007000">adjective</font> голословный<br>\nunfounded, baseless
горбатый(transitive)|горбат|горбата|горбато|горбаты	<font color="#007000">adjective</font> горбатый<br>\nhumpbacked, hunchbacked, having an abnormally protruding back due to a spinal deformity; camel back, humpy
грязная работа|грязный работа	nasty job
гусар|гусара|гусарам|гусарами|гусарах|гусаре|гусаров|гусаром|гусару|гусары	<font color="#007000">noun</font> гусар (m) <br>\nhussar, member of the Hungarian light cavalry; member of a European light cavalry regiment
дансинг|дансинга|дансингам|дансингами|дансингах|дансинге|дансинги|дансингов|дансингом|дансингу	<font color="#007000">noun</font> дансинг (m) <br>\ndancing hall, palais de dance
дачник|дачника|дачникам|дачниками|дачниках|дачнике|дачники|дачников|дачником|дачнику|дачниц|дачница|дачницам|дачницами|дачницах|дачнице|дачницей|дачницу|дачницы	<font color="#007000">noun</font> дачник (m) <br>\ncottager, summer resident
дверной звонок	<font color="#007000">noun</font><br>\ndoor bell
действовать в согласии|действовать в согласие	come into line
декогерировать|декогерировал|декогерировала|декогерировали|декогерировало|декогерируем|декогерирует|декогерируете|декогерируешь|декогерируй|декогерируйте|декогерирую|декогерируют	<font color="#007000">verb</font><br>\ndecohere
делать массаж	<font color="#007000">verb</font><br>\nmassage, give a massage
держаться незаметно	keep a low profile
детальность|детальностей|детальности|детальностью|детальностям|детальностями|детальностях	<font color="#007000">noun</font> детальность (f) <br>\nminuteness, detailed aspect
диада|диад|диадe|диадам|диадами|диадах|диаде|диадой|диадою|диаду|диады	<font color="#007000">noun</font> диада (f) <br>\ndyad
дивизионный|дивизионная|дивизионного|дивизионное|дивизионной|дивизионном|дивизионному|дивизионную|дивизионные|дивизионным|дивизионными|дивизионных	<font color="#007000">adjective</font><br>\ndivisional, squadron
додекаэдр|додекаэдра|додекаэдрам|додекаэдрами|додекаэдрах|додекаэдре|додекаэдров|додекаэдром|додекаэдру|додекаэдры	<font color="#007000">noun</font> додекаэдр (m) <br>\ndodecahedron
дорога с колеей|дорога с колея	<font color="#007000">noun</font><br>\ntrackway
дотошный|дотошная|дотошного|дотошное|дотошной|дотошном|дотошному|дотошную|дотошные|дотошным|дотошными|дотошных	<font color="#007000">adjective</font><br>\nmeticulous
дрянь человек	дрянь человек (mf) <br>\ndirty dog
дуэлянт|дуэлянта|дуэлянтам|дуэлянтами|дуэлянтах|дуэлянте|дуэлянтов|дуэлянтом|дуэлянту|дуэлянты	<font color="#007000">noun</font> дуэлянт (m) <br>\nduellist
забавник|забавника|забавникам|забавниками|забавниках|забавнике|забавники|забавников|забавником|забавнику	<font color="#007000">noun</font> забавник (m) <br>\njollier, merry maker
завещательница|завещательниц|завещательницe|завещательницам|завещательницами|завещательницах|завещательнице|завещательницей|завещательницею|завещательницу|завещательницы	<font color="#007000">noun</font> завещательница (f) <br>\ntestatrices, testatrix, woman who leaves a will
зависимая страна|зависимый страна	<font color="#007000">noun</font><br>\ndependency, territory subject to the dominion of another country
завуалированный|завуалированная|завуалированного|завуалированное|завуалированной|завуалированном|завуалированному|завуалированную|завуалированные|завуалированным|завуалированными|завуалированных	<font color="#007000">adjective</font><br>\ncovert
задираться|задираемся|задираетесь|задирается|задираешься|задирайся|задирайтесь|задиралась|задирались|задиралось|задирался|задираюсь|задираются	<font color="#007000">verb</font><br>\nbreak; ride up
задуть|задуем|задует|задуете|задуешь|задуй|задуйте|задул|задула|задули|задуло|задую|задуют	<font color="#007000">verb</font><br>\nblow in; blow out
зажариваться|зажариваемся|зажариваетесь|зажаривается|зажариваешься|зажаривайся|зажаривайтесь|зажаривалась|зажаривались|зажаривалось|зажаривался|зажариваюсь|зажариваются|зажарилась|зажарились|зажарилось|зажарился|зажаримся|зажарись|зажаритесь|зажарится|зажариться|зажаришься|зажарюсь|зажарятся	<font color="#007000">verb</font><br>\n<I>(perf. ><B>зажариться</B>)</I> be ready fried; be ready roasted, be ready broiled, be ready grilled
закутаться(transitive)|закутавшаяся|закутавшегося|закутавшееся|закутавшейся|закутавшемся|закутавшемуся|закутавшиеся|закутавшийся|закутавшимися|закутавшимся|закутавшись|закутавшихся|закутавшуюся	<font color="#007000">verb</font> закутаться<br>\nroll oneself up
заочные курсы|заочный курсы	<font color="#007000">noun</font><br>\ncorrespondence courses
запыхавшийся|запыхавшаяся|запыхавшегося|запыхавшееся|запыхавшейся|запыхавшемся|запыхавшемуся|запыхавшиеся|запыхавшимися|запыхавшимся|запыхавшихся|запыхавшуюся	<font color="#007000">adjective</font><br>\nbreathless, short of breath, winded
засохнуть|засох|засохла|засохли|засохло|засохнем|засохнет|засохнете|засохнешь|засохни|засохните|засохну|засохнул|засохнула|засохнули|засохнуло|засохнут	<font color="#007000">verb</font><br>\ndry up, wither
захватывающий фильм	<font color="#007000">noun</font><br>\nthriller
зоопарк|зоопарка|зоопаркам|зоопарками|зоопарках|зоопарке|зоопарки|зоопарков|зоопарком|зоопарку	<font color="#007000">noun</font> зоопарк (m) <br>\nzoo, animal zoo, garden where animals are kept for visitors to see and learn about
зря тратить деньги	muddle away one's money
зрячий|зрячая|зрячего|зрячее|зрячей|зрячем|зрячему|зрячие|зрячим|зрячими|зрячих|зрячую	<font color="#007000">adjective</font><br>\nsighted, able to see
идет снег	it snows, it is snowing
изболеться|изболеемся|изболеетесь|изболеется|изболеешься|изболейся|изболейтесь|изболелась|изболелись|изболелось|изболелся|изболеюсь|изболеются	<font color="#007000">verb</font><br>\nbe in torment, be tormented
извилистость|извилистостей|извилистости|извилистостью|извилистостям|извилистостями|извилистостях	<font color="#007000">noun</font> извилистость (f) <br>\ndeviousness, circuitousness; sinuosity, curviness; tortuosity, quality of being twisted
излюбленная тема|излюбленный тема	<font color="#007000">noun</font><br>\nhobbyhorse, pet idea or project
изменить место сбора|изменить место сбор	<font color="#007000">verb</font><br>\nshift the venue
изобрести новый план	<font color="#007000">verb</font><br>\nstrike out a new idea
изъявить|изъяви|изъявил|изъявила|изъявили|изъявило|изъявим|изъявит|изъявите|изъявишь|изъявлю|изъявляем|изъявляет|изъявляете|изъявляешь|изъявляй|изъявляйте|изъявлял|изъявляла|изъявляли|изъявляло|изъявлять|изъявляю|изъявляют|изъявят	<font color="#007000">verb</font><br>\n<I>(imperf. ><B>изъявлять</B>)</I> express
инфильтрация|инфильтрацией|инфильтрациею|инфильтрации|инфильтраций|инфильтрацию|инфильтрациям|инфильтрациями|инфильтрациях	<font color="#007000">noun</font> инфильтрация (f) <br>\ninfiltration, seepage
иск по суду|иск по суд	<font color="#007000">noun</font><br>\nplea, (Law) appeal
исторгнуть признание|исторгать признание	put somebody through the wringer
историограф|историографа|историографам|историографами|историографах|историографе|историографов|историографом|историографу|историографы	<font color="#007000">noun</font> историограф (m) <br>\nhistoriographer, annalist
исхоженный|исхоженная|исхоженного|исхоженное|исхоженной|исхоженном|исхоженному|исхоженную|исхоженные|исхоженным|исхоженными|исхоженных	<font color="#007000">adjective</font><br>\nfootworn
каждый встречный и поперечный	every mother's son, every man
как если бы	<font color="#007000">conjunction</font><br>\nas though
кальцинировать|кальцинировал|кальцинировала|кальцинировали|кальцинировало|кальцинируем|кальцинирует|кальцинируете|кальцинируешь|кальцинируй|кальцинируйте|кальцинирую|кальцинируют	<font color="#007000">verb</font><br>\ncalcine, reduce a substance to a powdery consistency by the application of a high heat, roast
камера сгорания|камера сгорание	<font color="#007000">noun</font><br>\ncombustion chamber, compression chamber
клематис|клематиса|клематисам|клематисами|клематисах|клематисе|клематисов|клематисом|клематису|клематисы	<font color="#007000">noun</font> клематис (m) <br>\nclematis, type of climbing plant
клепсидра|клепсидр|клепсидрe|клепсидрам|клепсидрами|клепсидрах|клепсидре|клепсидрой|клепсидрою|клепсидру|клепсидры	<font color="#007000">noun</font> клепсидра (f) <br>\nclepsydra
книга|книг|книгe|книгам|книгами|книгах|книге|книги|книгой|книгою|книгу	<font color="#007000">noun</font> книга (f) <br>\nbook; volume
кожистый|кожистая|кожистого|кожистое|кожистой|кожистом|кожистому|кожистую|кожистые|кожистым|кожистыми|кожистых	<font color="#007000">adjective</font><br>\ncoriaceous
комбинация|комбинацией|комбинациею|комбинации|комбинаций|комбинацию|комбинациям|комбинациями|комбинациях	<font color="#007000">noun</font> комбинация (f) <br>\ncombination; racket, deceptive act or scheme; slip, type of woman's undergarment
комнатная антенна|комнатный антенна	<font color="#007000">noun</font><br>\nindoor aerial, internal aerial
конский|конская|конские|конским|конскими|конских|конского|конское|конской|конском|конскому|конскую	<font color="#007000">adjective</font><br>\nhorse, equine
корректор-подчитчик|корректор подчитчик	<font color="#007000">noun</font> корректор-подчитчик (m) <br>\ncopyreader
коснеющий в грехе|коснеть в грех	<font color="#007000">adjective</font><br>\nreprobate
кривиться(transitive)|кривившаяся|кривившегося|кривившееся|кривившейся|кривившемся|кривившемуся|кривившиеся|кривившийся|кривившимися|кривившимся|кривившись|кривившихся|кривившуюся|кривясь|кривящаяся|кривящегося|кривящееся|кривящейся|кривящемся|кривящемуся|кривящиеся|кривящийся|кривящимися|кривящимся|кривящихся|кривящуюся|скривившаяся|скривившегося|скривившееся|скривившейся|скривившемся|скривившемуся|скривившиеся|скривившийся|скривившимися|скривившимся|скривившись|скривившихся|скривившуюся	<font color="#007000">verb</font> кривиться<br>\n<I>(perf. ><B>скривиться</B>)</I> bevel, cut a sloping edge; slant
кристалл|кристалла|кристаллам|кристаллами|кристаллах|кристалле|кристаллов|кристаллом|кристаллу|кристаллы	<font color="#007000">noun</font> кристалл (m) <br>\ncrystal, transparent mineral (especially a type of quartz)
ку клукс клан	ку клукс клан (m) <br>\nKu Klux Klan, KKK, radical white-supremacist organization in the United States
кулуары|кулуарам|кулуарами|кулуарах|кулуаров	<font color="#007000">noun</font> кулуары (pl) <br>\nlobby, large hall or near the entrance to a building
кутить(transitive)|кутив|кутившая|кутившего|кутившее|кутившей|кутившем|кутившему|кутивши|кутившие|кутивший|кутившим|кутившими|кутивших|кутившую|кутнув|кутнувшая|кутнувшего|кутнувшее|кутнувшей|кутнувшем|кутнувшему|кутнувши|кутнувшие|кутнувший|кутнувшим|кутнувшими|кутнувших|кутнувшую|кутя|кутящая|кутящего|кутящее|кутящей|кутящем|кутящему|кутящие|кутящий|кутящим|кутящими|кутящих|кутящую	<font color="#007000">verb</font> кутить<br>\n<I>(perf. ><B>кутнуть</B>)</I> revel; carouse
леггорн|леггорна|леггорнам|леггорнами|леггорнах|леггорне|леггорнов|леггорном|леггорну|леггорны	<font color="#007000">noun</font> леггорн (m) <br>\nLeghorn, Mediterranean breed of chicken that lays many eggs
лелеять(transitive)|лелеющая|лелеющего|лелеющее|лелеющей|лелеющем|лелеющему|лелеющие|лелеющий|лелеющим|лелеющими|лелеющих|лелеющую|лелея|лелеяв|лелеявшая|лелеявшего|лелеявшее|лелеявшей|лелеявшем|лелеявшему|лелеявши|лелеявшие|лелеявший|лелеявшим|лелеявшими|лелеявших|лелеявшую	<font color="#007000">verb</font> лелеять<br>\ncherish, nurture; entertain; nourish; nurse
лепиться|лепилась|лепились|лепилось|лепился|лепимся|лепись|лепитесь|лепится|лепишься|леплюсь|лепятся	<font color="#007000">verb</font><br>\ncling
лоскут|лоскута|лоскутам|лоскутами|лоскутах|лоскуте|лоскутов|лоскутом|лоскуту|лоскуты	<font color="#007000">noun</font> лоскут (m) <br>\nrag; patch; snippet
лучший из остальных|лучший из остальное	next best thing
любовь без взаимности|любовь без взаимность	<font color="#007000">noun</font><br>\nunanswered love, unrequited love
люпус|люпуса|люпусам|люпусами|люпусах|люпусе|люпусов|люпусом|люпусу|люпусы	<font color="#007000">noun</font> люпус (m) <br>\nlupus, any of several diseases which causes lesions on the skin
магический глаз	<font color="#007000">noun</font><br>\nmagic eye, electric eye
магнезия|магнезией|магнезиею|магнезии|магнезий|магнезию|магнезиям|магнезиями|магнезиях	<font color="#007000">noun</font> магнезия (f) <br>\nmagnesia, (Chemistry) magnesium oxide, white powdery compound (used in cosmetics, pharmaceuticals, etc.)
маленькое увлечение|маленький увлечение	<font color="#007000">noun</font><br>\nslight penchant
маммография|маммографией|маммографиею|маммографии|маммографий|маммографию|маммографиям|маммографиями|маммографиях	<font color="#007000">noun</font> маммография (f) <br>\nmammography, X-ray examination of the breast used to detect abnormalities
массивность|массивностей|массивности|массивностью|массивностям|массивностями|массивностях	<font color="#007000">noun</font> массивность (f) <br>\nmassiveness, solidness
матовое золото|матовый золото	<font color="#007000">noun</font><br>\ndead gold
медиевист|медиевиста|медиевистам|медиевистами|медиевистах|медиевисте|медиевистов|медиевистом|медиевисту|медиевисты	<font color="#007000">noun</font> медиевист (m) <br>\nmedievalist, researcher of the Middle Ages; expert in medieval history; one greatly attracted to medieval things
место работы|место работа	<font color="#007000">noun</font><br>\njob, work
мидия|мидией|мидиею|мидии|мидий|мидию|мидиям|мидиями|мидиях	<font color="#007000">noun</font> мидия (f) <br>\nmussel, edible bivalve mollusk
микрофон|микрофона|микрофонам|микрофонами|микрофонах|микрофоне|микрофонов|микрофоном|микрофону|микрофоны	<font color="#007000">noun</font> микрофон (m) <br>\nmicrophone, mike, device which converts sound waves into electronic signals for recording and amplification or broadcast.
молодой месяц	<font color="#007000">noun</font><br>\nnew moon
молоко|молока|молоке|молоком|молоку	<font color="#007000">noun</font> молоко (n) <br>\nmilk, white liquid produced by female mammals that serves as nourishment for their young; this liquid from some mammals (cows, sheep, and goats) that is processed for human consumption; similar liquid produced by certain plants (as the coconut)
молочный|молочная|молочного|молочное|молочной|молочном|молочному|молочную|молочные|молочным|молочными|молочных	<font color="#007000">adjective</font><br>\nmilky, milk, lactic
морская пограничная служба|морской пограничный служба	<font color="#007000">noun</font><br>\ncoastguard
мотор|мотора|моторам|моторами|моторах|моторе|моторов|мотором|мотору|моторы	<font color="#007000">noun</font> мотор (m) <br>\nmotor, engine
наборная машина|наборный машина	<font color="#007000">noun</font><br>\ntypesetter, typesetting machine
наводчик|наводчика|наводчикам|наводчиками|наводчиках|наводчике|наводчики|наводчиков|наводчиком|наводчику	<font color="#007000">noun</font> наводчик (m) <br>\ngun-layer; pointer
наклеп|наклепа|наклепам|наклепами|наклепах|наклепе|наклепов|наклепом|наклепу|наклепы	<font color="#007000">noun</font> наклеп (m) <br>\ncold hardening
напиваться(transitive)|напивавшаяся|напивавшегося|напивавшееся|напивавшейся|напивавшемся|напивавшемуся|напивавшиеся|напивавшийся|напивавшимися|напивавшимся|напивавшись|напивавшихся|напивавшуюся|напивающаяся|напивающегося|напивающееся|напивающейся|напивающемся|напивающемуся|напивающиеся|напивающийся|напивающимися|напивающимся|напивающихся|напивающуюся|напиваясь	<font color="#007000">verb</font> напиваться<br>\nget drunk, booze, intoxicate
напрасное усилие|напрасный усилие	lost effort; dead lift, waste effort
нарезка резьбы|нарезка резьба	<font color="#007000">noun</font><br>\ntapping
настойчивая просьба|настойчивый просьба	<font color="#007000">noun</font><br>\nsolicitation, entreaty
находить выход	<font color="#007000">verb</font><br>\nsolve, find a solution
начальник дока	<font color="#007000">noun</font><br>\ndock master
начать тяжбу|начать тяжба	take issue, join issue
не обремененный	<font color="#007000">adjective</font><br>\nunencumbered, unladen
невзыскательный(transitive)|невзыскателен|невзыскательна|невзыскательно|невзыскательны	<font color="#007000">adjective</font> невзыскательный<br>\nundemanding
неврология|неврологией|неврологиею|неврологии|неврологий|неврологию|неврологиям|неврологиями|неврологиях	<font color="#007000">noun</font> неврология (f) <br>\nneurology, science of the functions and disorders of the nervous system (Medicine)
незапланированный|незапланированная|незапланированного|незапланированное|незапланированной|незапланированном|незапланированному|незапланированную|незапланированные|незапланированным|незапланированными|незапланированных	<font color="#007000">adjective</font><br>\nextemporaneous
неистощимый|неистощимая|неистощимого|неистощимое|неистощимой|неистощимом|неистощимому|неистощимую|неистощимые|неистощимым|неистощимыми|неистощимых	<font color="#007000">adjective</font><br>\ninexhaustible
некомпетентность|некомпетентностей|некомпетентности|некомпетентностью|некомпетентностям|некомпетентностями|некомпетентностях	<font color="#007000">noun</font> некомпетентность (f) <br>\nincompetence
немеченый|немеченая|немеченого|немеченое|немеченой|немеченом|немеченому|немеченую|немеченые|немеченым|немечеными|немеченых	<font color="#007000">adjective</font><br>\nunmarked
неприспособленный|неприспособленная|неприспособленного|неприспособленное|неприспособленной|неприспособленном|неприспособленному|неприспособленную|неприспособленные|неприспособленным|неприспособленными|неприспособленных	<font color="#007000">adjective</font><br>\nnot suited to, not adapted; unequipped
несварение|несварением|несварении|несварений|несварению|несварения|несварениям|несварениями|несварениях	<font color="#007000">noun</font> несварение (n) <br>\nindigestion
неспособный|неспособная|неспособного|неспособное|неспособной|неспособном|неспособному|неспособную|неспособные|неспособным|неспособными|неспособных	<font color="#007000">adjective</font><br>\nincapable, incompetent; inefficient
нижняя юбка|нижний юбка	<font color="#007000">noun</font><br>\nunderskirt, petticoat, slip
обессиленный|обессиленная|обессиленного|обессиленное|обессиленной|обессиленном|обессиленному|обессиленную|обессиленные|обессиленным|обессиленными|обессиленных	<font color="#007000">adjective</font><br>\nexhausted; prostrate; bleeding
обитаемый|обитаемая|обитаемого|обитаемое|обитаемой|обитаемом|обитаемому|обитаемую|обитаемые|обитаемым|обитаемыми|обитаемых	<font color="#007000">adjective</font><br>\nhabitable; inhabited
обращаться за помощью|обращаться за помощь	<font color="#007000">verb</font><br>\nresort, have recourse to, have recurrence to
обсуждать по пунктам|обсуждать по пункт	<font color="#007000">verb</font><br>\ndiscuss seriatim
обязательно приходите	don't fail to come
окачивать(transitive)|окачивав|окачивавшая|окачивавшего|окачивавшее|окачивавшей|окачивавшем|окачивавшему|окачивавши|окачивавшие|окачивавший|окачивавшим|окачивавшими|окачивавших|окачивавшую|окачиваема|окачиваемая|окачиваемо|окачиваемого|окачиваемое|окачиваемой|окачиваемом|окачиваемому|окачиваемую|окачиваемы|окачиваемые|окачиваемый|окачиваемым|окачиваемыми|окачиваемых|окачивающая|окачивающего|окачивающее|окачивающей|окачивающем|окачивающему|окачивающие|окачивающий|окачивающим|окачивающими|окачивающих|окачивающую|окачивая	<font color="#007000">verb</font> окачивать<br>\nsouse
олицетворять(transitive)|олицетворяв|олицетворявшая|олицетворявшего|олицетворявшее|олицетворявшей|олицетворявшем|олицетворявшему|олицетворявши|олицетворявшие|олицетворявший|олицетворявшим|олицетворявшими|олицетворявших|олицетворявшую|олицетворяема|олицетворяемая|олицетворяемо|олицетворяемого|олицетворяемое|олицетворяемой|олицетворяемом|олицетворяемому|олицетворяемую|олицетворяемы|олицетворяемые|олицетворяемый|олицетворяемым|олицетворяемыми|олицетворяемых|олицетворяющая|олицетворяющего|олицетворяющее|олицетворяющей|олицетворяющем|олицетворяющему|олицетворяющие|олицетворяющий|олицетворяющим|олицетворяющими|олицетворяющих|олицетворяющую|олицетворяя	<font color="#007000">verb</font> олицетворять<br>\nembody, incarnate; impersonate; personify, typify
опал|опала|опалам|опалами|опалах|опале|опалов|опалом|опалу|опалы	<font color="#007000">noun</font> опал (m) <br>\nopal, iridescent semi-precious stone of hydrated silica
оползень|оползене|оползеней|оползенем|оползени|оползеню|оползеня|оползеням|оползенями|оползенях	<font color="#007000">noun</font> оползень (m) <br>\nlandslide, landslip
ополчиться(transitive)|ополчившаяся|ополчившегося|ополчившееся|ополчившейся|ополчившемся|ополчившемуся|ополчившиеся|ополчившийся|ополчившимися|ополчившимся|ополчившись|ополчившихся|ополчившуюся	<font color="#007000">verb</font> ополчиться<br>\nrise in arms
организовать диверсии|организовать диверсия	<font color="#007000">verb</font><br>\nengineer acts of sabotage
орошать|ороси|оросил|оросила|оросили|оросило|оросим|оросит|оросите|оросить|оросишь|оросят|орошаем|орошает|орошаете|орошаешь|орошай|орошайте|орошал|орошала|орошали|орошало|орошаю|орошают|орошу	<font color="#007000">verb</font><br>\n<I>(perf. ><B>оросить</B>)</I> irrigate; shower; water; flood
освободительная война|освободительный война	<font color="#007000">noun</font><br>\nliberation war
оселок|оселка|оселкам|оселками|оселках|оселке|оселки|оселков|оселком|оселку	<font color="#007000">noun</font> оселок (m) <br>\ntouchstone; hone, whetstone
осматривающий|осматривающая|осматривающего|осматривающее|осматривающей|осматривающем|осматривающему|осматривающие|осматривающим|осматривающими|осматривающих|осматривающую	<font color="#007000">adjective</font><br>\ncircumspective
основанный на вере|основанный на вера	<font color="#007000">adjective</font><br>\nfiducial
остроумие|остроумием|остроумии|остроумий|остроумию|остроумия|остроумиям|остроумиями|остроумиях	<font color="#007000">noun</font> остроумие (n) <br>\nesprit, lively wit, smartness
осязательный(transitive)|осязателен|осязательна|осязательно|осязательны	<font color="#007000">adjective</font> осязательный<br>\ntactile, tangible, pertaining to the sense of touch
открытка|открыткe|открыткам|открытками|открытках|открытке|открытки|открыткой|открыткою|открытку|открыток	<font color="#007000">noun</font> открытка (f) <br>\npostcard, small card sent by mail (often with a photograph on one side)
отлакировать|отлакировал|отлакировала|отлакировали|отлакировало|отлакируем|отлакирует|отлакируете|отлакируешь|отлакируй|отлакируйте|отлакирую|отлакируют	<font color="#007000">verb</font><br>\nvarnish
оттолкнуть(transitive)|оттолкнув|оттолкнувшая|оттолкнувшего|оттолкнувшее|оттолкнувшей|оттолкнувшем|оттолкнувшему|оттолкнувши|оттолкнувшие|оттолкнувший|оттолкнувшим|оттолкнувшими|оттолкнувших|оттолкнувшую|оттолкнута|оттолкнутая|оттолкнуто|оттолкнутого|оттолкнутое|оттолкнутой|оттолкнутом|оттолкнутому|оттолкнутую|оттолкнуты|оттолкнутые|оттолкнутый|оттолкнутым|оттолкнутыми|оттолкнутых	<font color="#007000">verb</font> оттолкнуть<br>\njostle away, spurn, repel
оцинкованное железо|оцинкованный железо	<font color="#007000">noun</font><br>\ngalvanized iron
очевидно	<font color="#007000">adverb</font><br>\nevidently, obviously, apparently, clearly
очень давно	<font color="#007000">adverb</font><br>\nyears and years ago
паросский|паросская|паросские|паросским|паросскими|паросских|паросского|паросское|паросской|паросском|паросскому|паросскую	<font color="#007000">adjective</font><br>\nParian
первобытность|первобытностей|первобытности|первобытностью|первобытностям|первобытностями|первобытностях	<font color="#007000">noun</font> первобытность (f) <br>\nprimitive state
перекраивать(transitive)|перекраивав|перекраивавшая|перекраивавшего|перекраивавшее|перекраивавшей|перекраивавшем|перекраивавшему|перекраивавши|перекраивавшие|перекраивавший|перекраивавшим|перекраивавшими|перекраивавших|перекраивавшую|перекраиваема|перекраиваемая|перекраиваемо|перекраиваемого|перекраиваемое|перекраиваемой|перекраиваемом|перекраиваемому|перекраиваемую|перекраиваемы|перекраиваемые|перекраиваемый|перекраиваемым|перекраиваемыми|перекраиваемых|перекраивающая|перекраивающего|перекраивающее|перекраивающей|перекраивающем|перекраивающему|перекраивающие|перекраивающий|перекраивающим|перекраивающими|перекраивающих|перекраивающую|перекраивая	<font color="#007000">verb</font> перекраивать<br>\nrehash, make superficial changes to old ideas or creations and present them as new
перелезать(transitive)|перелезав|перелезавшая|перелезавшего|перелезавшее|перелезавшей|перелезавшем|перелезавшему|перелезавши|перелезавшие|перелезавший|перелезавшим|перелезавшими|перелезавших|перелезавшую|перелезаема|перелезаемая|перелезаемо|перелезаемого|перелезаемое|перелезаемой|перелезаемом|перелезаемому|перелезаемую|перелезаемы|перелезаемые|перелезаемый|перелезаемым|перелезаемыми|перелезаемых|перелезающая|перелезающего|перелезающее|перелезающей|перелезающем|перелезающему|перелезающие|перелезающий|перелезающим|перелезающими|перелезающих|перелезающую|перелезая|перелезшая|перелезшего|перелезшее|перелезшей|перелезшем|перелезшему|перелезши|перелезшие|перелезший|перелезшим|перелезшими|перелезших|перелезшую	<font color="#007000">verb</font> перелезать<br>\n<I>(perf. ><B>перелезть,,ь</B>)</I> climb over
перестилать(transitive)|перестелив|перестелившая|перестелившего|перестелившее|перестелившей|перестелившем|перестелившему|перестеливши|перестелившие|перестеливший|перестелившим|перестелившими|перестеливших|перестелившую|перестелин|перестелина|перестелинная|перестелинного|перестелинное|перестелинной|перестелинном|перестелинному|перестелинную|перестелинные|перестелинный|перестелинным|перестелинными|перестелинных|перестелино|перестелины|перестилав|перестилавшая|перестилавшего|перестилавшее|перестилавшей|перестилавшем|перестилавшему|перестилавши|перестилавшие|перестилавший|перестилавшим|перестилавшими|перестилавших|перестилавшую|перестилаема|перестилаемая|перестилаемо|перестилаемого|перестилаемое|перестилаемой|перестилаемом|перестилаемому|перестилаемую|перестилаемы|перестилаемые|перестилаемый|перестилаемым|перестилаемыми|перестилаемых|перестилающая|перестилающего|перестилающее|перестилающей|перестилающем|перестилающему|перестилающие|перестилающий|перестилающим|перестилающими|перестилающих|перестилающую|перестилая	<font color="#007000">verb</font> перестилать<br>\n<I>(perf. ><B>перестелить</B>)</I> relay
пинка|пинкe|пинкам|пинками|пинках|пинке|пинки|пинкой|пинкою|пинку|пинок	<font color="#007000">noun</font> пинка (f) <br>\npink
плантатор|плантатора|плантаторам|плантаторами|плантаторах|плантаторе|плантаторов|плантатором|плантатору|плантаторы	<font color="#007000">noun</font> плантатор (m) <br>\nplanter, owner of a plantation
побежденный(transitive)|побежден|побеждена|побеждено|побеждены	<font color="#007000">adjective</font> побежденный<br>\nbeaten, defeated
повторяющий|повторяющая|повторяющего|повторяющее|повторяющей|повторяющем|повторяющему|повторяющие|повторяющим|повторяющими|повторяющих|повторяющую	<font color="#007000">adjective</font><br>\nrepeating
погост|погоста|погостам|погостами|погостах|погосте|погостов|погостом|погосту|погосты	<font color="#007000">noun</font> погост (m) <br>\nchurchyard
подкатывать|подкатываем|подкатывает|подкатываете|подкатываешь|подкатывай|подкатывайте|подкатывал|подкатывала|подкатывали|подкатывало|подкатываю|подкатывают	<font color="#007000">verb</font><br>\ndrive up
подле	<font color="#007000">adverb</font><br>\nnear
подсуживать|подсуживаем|подсуживает|подсуживаете|подсуживаешь|подсуживай|подсуживайте|подсуживал|подсуживала|подсуживали|подсуживало|подсуживаю|подсуживают	<font color="#007000">verb</font><br>\nfavor
покрыть дефицит	meet a deficit
полеживать(transitive)|полеживав|полеживавшая|полеживавшего|полеживавшее|полеживавшей|полеживавшем|полеживавшему|полеживавши|полеживавшие|полеживавший|полеживавшим|полеживавшими|полеживавших|полеживавшую|полеживаема|полеживаемая|полеживаемо|полеживаемого|полеживаемое|полеживаемой|полеживаемом|полеживаемому|полеживаемую|полеживаемы|полеживаемые|полеживаемый|полеживаемым|полеживаемыми|полеживаемых|полеживающая|полеживающего|полеживающее|полеживающей|полеживающем|полеживающему|полеживающие|полеживающий|полеживающим|полеживающими|полеживающих|полеживающую|полеживая	<font color="#007000">verb</font> полеживать<br>\nlie down
полиграфия|полиграфией|полиграфиею|полиграфии|полиграфий|полиграфию|полиграфиям|полиграфиями|полиграфиях	<font color="#007000">noun</font> полиграфия (f) <br>\npolygraphy
полновластный(transitive)|полновластен|полновластна|полновластно|полновластны	<font color="#007000">adjective</font> полновластный<br>\nsovereign
полужидкий|полужидкая|полужидкие|полужидким|полужидкими|полужидких|полужидкого|полужидкое|полужидкой|полужидком|полужидкому|полужидкую	<font color="#007000">adjective</font><br>\nsemifluid, having the qualities of both a liquid and a solid
получить слово	get the floor
попасть пальцем в небо|попасть палец в небо	take the wrong sow by the ear, get the wrong sow by the ear, find a mare's nest
пособия|пособий|пособиям|пособиями|пособиях	<font color="#007000">noun</font> пособия (pl) <br>\naid
поставлять(transitive)|поставляв|поставлявшая|поставлявшего|поставлявшее|поставлявшей|поставлявшем|поставлявшему|поставлявши|поставлявшие|поставлявший|поставлявшим|поставлявшими|поставлявших|поставлявшую|поставляема|поставляемая|поставляемо|поставляемого|поставляемое|поставляемой|поставляемом|поставляемому|поставляемую|поставляемы|поставляемые|поставляемый|поставляемым|поставляемыми|поставляемых|поставляющая|поставляющего|поставляющее|поставляющей|поставляющем|поставляющему|поставляющие|поставляющий|поставляющим|поставляющими|поставляющих|поставляющую|поставляя	<font color="#007000">verb</font> поставлять<br>\npurvey, supply; deliver; cater
постоянный(transitive)|постоянен|постоянна|постояннее|постоянней|постоянно|постоянны	<font color="#007000">adjective</font> постоянный<br>\ncontinual, perpetual, constant; continuous, uninterrupted; perdurable, permanent; direct; in ordinary
потерпеть	<font color="#007000">verb</font><br>\nsuffer, endure
потерпеть фиаско	go flop
потом	<font color="#007000">adverb</font><br>\nafter, afterwards, next, subsequently, then
поэзия|поэзией|поэзиею|поэзии|поэзий|поэзию|поэзиям|поэзиями|поэзиях	<font color="#007000">noun</font> поэзия (f) <br>\npoetry, verse; rhyme; strain
праздник Первого мая|праздник Первого май	<font color="#007000">noun</font><br>\nMay Day, holiday celebrated on the 1st of May in honor of workers and labor organizations
прежний	<font color="#007000">prefix</font><br>\nex
презрительно	<font color="#007000">adverb</font><br>\ncontemptuously, scornfully
преувеличивающий|преувеличивающая|преувеличивающего|преувеличивающее|преувеличивающей|преувеличивающем|преувеличивающему|преувеличивающие|преувеличивающим|преувеличивающими|преувеличивающих|преувеличивающую	<font color="#007000">adjective</font><br>\nexaggerative
приведение в действие	<font color="#007000">noun</font><br>\noperation, actuation
прививка|прививкe|прививкам|прививками|прививках|прививке|прививки|прививкой|прививкою|прививку|прививок	<font color="#007000">noun</font> прививка (f) <br>\ngraft; vaccination, inoculation; jab
приличествовать	<font color="#007000">verb</font><br>\nbefit, beseem, become
применимый(transitive)|применим|применима|применимо|применимы	<font color="#007000">adjective</font> применимый<br>\napplicable
проектировать|спроектировать	<font color="#007000">verb</font><br>\n<I>(perf. ><B>спроектировать</B>)</I> project, scheme, plan; design; engineer
просроченный(transitive)|просрочен|просрочена|просрочено|просрочены	<font color="#007000">adjective</font> просроченный<br>\noverdue; outstanding, unsettled; back
протирать|протереть	<font color="#007000">verb</font><br>\n<I>(perf. ><B>протереть</B>)</I> clean; wipe, rub; fray
проявить неуважение к кому л.	put a slight upon smb.
пустые слова|пустой слова	<font color="#007000">noun</font><br>\nempty words, words empty of meaning, fluent phrases, froth, something unsubstantial, verbalism, vacuity, lip service, wind
работать с душой	put life into one's work
развесистый|развесистая|развесистого|развесистое|развесистой|развесистом|развесистому|развесистую|развесистые|развесистым|развесистыми|развесистых	<font color="#007000">adjective</font><br>\nspreading; branching
раздосадованный|раздосадованная|раздосадованного|раздосадованное|раздосадованной|раздосадованном|раздосадованному|раздосадованную|раздосадованные|раздосадованным|раздосадованными|раздосадованных	<font color="#007000">adjective</font><br>\nvexed, annoyed; dissatisfied, discontented; sick
раззадорить(transitive)|раззадоривав|раззадоривавшая|раззадоривавшего|раззадоривавшее|раззадоривавшей|раззадоривавшем|раззадоривавшему|раззадоривавши|раззадоривавшие|раззадоривавший|раззадоривавшим|раззадоривавшими|раззадоривавших|раззадоривавшую|раззадориваема|раззадориваемая|раззадориваемо|раззадориваемого|раззадориваемое|раззадориваемой|раззадориваемом|раззадориваемому|раззадориваемую|раззадориваемы|раззадориваемые|раззадориваемый|раззадориваемым|раззадориваемыми|раззадориваемых|раззадоривающая|раззадоривающего|раззадоривающее|раззадоривающей|раззадоривающем|раззадоривающему|раззадоривающие|раззадоривающий|раззадоривающим|раззадоривающими|раззадоривающих|раззадоривающую|раззадоривая	<font color="#007000">verb</font> раззадорить<br>\n<I>(imperf. ><B>раззадоривать</B>)</I> whet, stimulate
раззванивать(transitive)|раззванивав|раззванивавшая|раззванивавшего|раззванивавшее|раззванивавшей|раззванивавшем|раззванивавшему|раззванивавши|раззванивавшие|раззванивавший|раззванивавшим|раззванивавшими|раззванивавших|раззванивавшую|раззваниваема|раззваниваемая|раззваниваемо|раззваниваемого|раззваниваемое|раззваниваемой|раззваниваемом|раззваниваемому|раззваниваемую|раззваниваемы|раззваниваемые|раззваниваемый|раззваниваемым|раззваниваемыми|раззваниваемых|раззванивающая|раззванивающего|раззванивающее|раззванивающей|раззванивающем|раззванивающему|раззванивающие|раззванивающий|раззванивающим|раззванивающими|раззванивающих|раззванивающую|раззванивая|раззвонив|раззвонившая|раззвонившего|раззвонившее|раззвонившей|раззвонившем|раззвонившему|раззвонивши|раззвонившие|раззвонивший|раззвонившим|раззвонившими|раззвонивших|раззвонившую	<font color="#007000">verb</font> раззванивать<br>\n<I>(perf. ><B>раззвонить</B>)</I> trumpet
различаться(transitive)|различавшаяся|различавшегося|различавшееся|различавшейся|различавшемся|различавшемуся|различавшиеся|различавшийся|различавшимися|различавшимся|различавшись|различавшихся|различавшуюся|различающаяся|различающегося|различающееся|различающейся|различающемся|различающемуся|различающиеся|различающийся|различающимися|различающимся|различающихся|различающуюся|различаясь	<font color="#007000">verb</font> различаться<br>\ndiffer, differentiate
размякать(transitive)|размякав|размякавшая|размякавшего|размякавшее|размякавшей|размякавшем|размякавшему|размякавши|размякавшие|размякавший|размякавшим|размякавшими|размякавших|размякавшую|размякающая|размякающего|размякающее|размякающей|размякающем|размякающему|размякающие|размякающий|размякающим|размякающими|размякающих|размякающую|размякая|размякнув|размякшая|размякшего|размякшее|размякшей|размякшем|размякшему|размякши|размякшие|размякший|размякшим|размякшими|размякших|размякшую	<font color="#007000">verb</font> размякать<br>\n<I>(perf. ><B>размякнуть</B>)</I> soften
разъяснять|разъясняем|разъясняет|разъясняете|разъясняешь|разъясняй|разъясняйте|разъяснял|разъясняла|разъясняли|разъясняло|разъясняю|разъясняют	<font color="#007000">verb</font><br>\nexpound, explain; elucidate, illuminate
распарывать|распарываем|распарывает|распарываете|распарываешь|распарывай|распарывайте|распарывал|распарывала|распарывали|распарывало|распарываю|распарывают	<font color="#007000">verb</font><br>\nrip up; unpick, unstitch
распутный|распутная|распутного|распутное|распутной|распутном|распутному|распутную|распутные|распутным|распутными|распутных	<font color="#007000">adjective</font><br>\ndebauched, depraved, wanton, corrupt, licentious
расстричь(transitive)|расстригав|расстригавшая|расстригавшего|расстригавшее|расстригавшей|расстригавшем|расстригавшему|расстригавши|расстригавшие|расстригавший|расстригавшим|расстригавшими|расстригавших|расстригавшую|расстригаема|расстригаемая|расстригаемо|расстригаемого|расстригаемое|расстригаемой|расстригаемом|расстригаемому|расстригаемую|расстригаемы|расстригаемые|расстригаемый|расстригаемым|расстригаемыми|расстригаемых|расстригающая|расстригающего|расстригающее|расстригающей|расстригающем|расстригающему|расстригающие|расстригающий|расстригающим|расстригающими|расстригающих|расстригающую|расстригая|расстригшая|расстригшего|расстригшее|расстригшей|расстригшем|расстригшему|расстригши|расстригшие|расстригший|расстригшим|расстригшими|расстригших|расстригшую|расстрижен|расстрижена|расстриженная|расстриженного|расстриженное|расстриженной|расстриженном|расстриженному|расстриженную|расстриженные|расстриженный|расстриженным|расстриженными|расстриженных|расстрижено|расстрижены	<font color="#007000">verb</font> расстричь<br>\n<I>(imperf. ><B>расстригать</B>)</I> defrock
рдеть|рдеем|рдеет|рдеете|рдеешь|рдей|рдейте|рдел|рдела|рдели|рдело|рдею|рдеют	<font color="#007000">verb</font><br>\nglow; color up; color
реабилитированный|реабилитированная|реабилитированного|реабилитированное|реабилитированной|реабилитированном|реабилитированному|реабилитированную|реабилитированные|реабилитированным|реабилитированными|реабилитированных	<font color="#007000">adjective</font><br>\nexonerate
ревербератор|ревербератора|ревербераторам|ревербераторами|ревербераторах|ревербераторе|ревербераторов|ревербератором|ревербератору|ревербераторы	<font color="#007000">noun</font> ревербератор (m) <br>\nreverberator
регулирующийся|регулирующаяся|регулирующегося|регулирующееся|регулирующейся|регулирующемся|регулирующемуся|регулирующиеся|регулирующимися|регулирующимся|регулирующихся|регулирующуюся	<font color="#007000">adjective</font><br>\nadjustable, capable of being adjusted
резкие черты лица|резкий черты лицо	<font color="#007000">noun</font><br>\nrugged features
ремень безопасности|ремень безопасность	<font color="#007000">noun</font><br>\nsafety belt, seat belt
респонсорий|респонсориев|респонсорием|респонсории|респонсорию|респонсория|респонсориям|респонсориями|респонсориях	<font color="#007000">noun</font> респонсорий (m) <br>\nresponsory
речушка|речушек|речушкe|речушкам|речушками|речушках|речушке|речушки|речушкой|речушкою|речушку	<font color="#007000">noun</font> речушка (f) <br>\nrivulet, small stream, brook, creek
робототехника|робототехник|робототехникe|робототехникам|робототехниками|робототехниках|робототехнике|робототехники|робототехникой|робототехникою|робототехнику	<font color="#007000">noun</font> робототехника (f) <br>\nrobotics, technology dealing with the construction and use of robots
рок|рока|рокам|роками|роках|роке|роки|роков|роком|року	<font color="#007000">noun</font> рок (m) <br>\nfate, doom; destiny, kismet; rock and roll, rock music
роялист|роялиста|роялистам|роялистами|роялистах|роялисте|роялистов|роялистом|роялисту|роялисты	<font color="#007000">noun</font> роялист (m) <br>\nroyalist; cavalier
с головы до ног|с голова до ноги	at every pore, every inch
салака|салак|салакe|салакам|салаками|салаках|салаке|салаки|салакой|салакою|салаку	<font color="#007000">noun</font> салака (f) <br>\nsprat
сатурнизм|сатурнизма|сатурнизмам|сатурнизмами|сатурнизмах|сатурнизме|сатурнизмов|сатурнизмом|сатурнизму|сатурнизмы	<font color="#007000">noun</font> сатурнизм (m) <br>\nsaturnism (Medicine), lead poisoning, condition resulting from the absorption of lead into the body (causes anemia, muscle weakness, and nausea)
свистать(transitive)|свистав|свиставшая|свиставшего|свиставшее|свиставшей|свиставшем|свиставшему|свиставши|свиставшие|свиставший|свиставшим|свиставшими|свиставших|свиставшую|свистающая|свистающего|свистающее|свистающей|свистающем|свистающему|свистающие|свистающий|свистающим|свистающими|свистающих|свистающую|свистая	<font color="#007000">verb</font> свистать<br>\npipe, make a high-pitched sound
сводчатый|сводчатая|сводчатого|сводчатое|сводчатой|сводчатом|сводчатому|сводчатую|сводчатые|сводчатым|сводчатыми|сводчатых	<font color="#007000">adjective</font><br>\narch, vaulted, convex, curved
сгладить(transitive)|сгладив|сгладившая|сгладившего|сгладившее|сгладившей|сгладившем|сгладившему|сгладивши|сгладившие|сгладивший|сгладившим|сгладившими|сгладивших|сгладившую|сглажен|сглажена|сглаженная|сглаженного|сглаженное|сглаженной|сглаженном|сглаженному|сглаженную|сглаженные|сглаженный|сглаженным|сглаженными|сглаженных|сглажено|сглажены	<font color="#007000">verb</font> сгладить<br>\nsmooth
северо-запад|северо запад	<font color="#007000">noun</font> северо-запад (m) <br>\nnorth west
сжатость|сжатостей|сжатости|сжатостью|сжатостям|сжатостями|сжатостях	<font color="#007000">noun</font> сжатость (f) <br>\nbriefness, conciseness; condensation, something that has been shortened
сказываться(transitive)|сказавшаяся|сказавшегося|сказавшееся|сказавшейся|сказавшемся|сказавшемуся|сказавшиеся|сказавшийся|сказавшимися|сказавшимся|сказавшись|сказавшихся|сказавшуюся|сказывавшаяся|сказывавшегося|сказывавшееся|сказывавшейся|сказывавшемся|сказывавшемуся|сказывавшиеся|сказывавшийся|сказывавшимися|сказывавшимся|сказывавшись|сказывавшихся|сказывавшуюся|сказывающаяся|сказывающегося|сказывающееся|сказывающейся|сказывающемся|сказывающемуся|сказывающиеся|сказывающийся|сказывающимися|сказывающимся|сказывающихся|сказывающуюся|сказываясь	<font color="#007000">verb</font> сказываться<br>\n<I>(perf. ><B>сказаться</B>)</I> tell; tell the truth
слесарь-монтажник|слесарь монтажник	<font color="#007000">noun</font> слесарь-монтажник (m) <br>\nfitter
слоновость|слоновостей|слоновости|слоновостью|слоновостям|слоновостями|слоновостях	<font color="#007000">noun</font> слоновость (f) <br>\nelephantiasis, abnormal enlargement of parts of the body (disease)
смотри ниже	<font color="#007000">adverb</font><br>\nvide infra
сосняк|сосняка|соснякам|сосняками|сосняках|сосняке|сосняки|сосняков|сосняком|сосняку	<font color="#007000">noun</font> сосняк (m) <br>\npinery, pine forest
сочинение|сочинением|сочинении|сочинений|сочинению|сочинения|сочинениям|сочинениями|сочинениях	<font color="#007000">noun</font> сочинение (n) <br>\ncomposition; work; coordination; opus, musical work or composition
спрыскивать|спрыскиваем|спрыскивает|спрыскиваете|спрыскиваешь|спрыскивай|спрыскивайте|спрыскивал|спрыскивала|спрыскивали|спрыскивало|спрыскиваю|спрыскивают|спрыснуть	<font color="#007000">verb</font><br>\n<I>(perf. ><B>спрыснуть</B>)</I> sprinkle
старающийся замаскировать бедность	<font color="#007000">adjective</font><br>\nshabby genteel
стелить постель	<font color="#007000">verb</font><br>\nmake the bed
стрельба из лука	<font color="#007000">noun</font><br>\narchery
суммирующий|суммирующая|суммирующего|суммирующее|суммирующей|суммирующем|суммирующему|суммирующие|суммирующим|суммирующими|суммирующих|суммирующую	<font color="#007000">adjective</font><br>\nrecapitulative, summarizing
существенный(transitive)|существен|существенна|существенно|существенны	<font color="#007000">adjective</font> существенный<br>\nimportant, significant; essential, integral, intrinsic; substantial; constitutive
сыро	<font color="#007000">adverb</font><br>\nit is wet
также ... не	<font color="#007000">conjunction</font><br>\nnor
танжерский|танжерская|танжерские|танжерским|танжерскими|танжерских|танжерского|танжерское|танжерской|танжерском|танжерскому|танжерскую	<font color="#007000">adjective</font><br>\ntangerine
телефонный аппарат	<font color="#007000">noun</font><br>\ntelephone set
ткань|тканей|ткани|тканью|тканям|тканями|тканях	<font color="#007000">noun</font> ткань (f) <br>\ncloth, fabric, material (woven of wool, cotton, etc.); textile, weave; tissue (Biology)
топотать	<font color="#007000">verb</font><br>\nbrattle; patter
трихина|трихин|трихинe|трихинам|трихинами|трихинах|трихине|трихиной|трихиною|трихину|трихины	<font color="#007000">noun</font> трихина (f) <br>\ntrichina, parasitic worm which lives in the intestine and whose larva encysts in muscle tissue, Trichinella spiralis
троглодит|троглодита|троглодитам|троглодитами|троглодитах|троглодите|троглодитов|троглодитом|троглодиту|троглодиты	<font color="#007000">noun</font> троглодит (m) <br>\ntroglodyte, cave dweller
трубадур|трубадура|трубадурам|трубадурами|трубадурах|трубадуре|трубадуров|трубадуром|трубадуру|трубадуры	<font color="#007000">noun</font> трубадур (m) <br>\ntroubadour, medieval European poet and musician
трюизм|трюизма|трюизмам|трюизмами|трюизмах|трюизме|трюизмов|трюизмом|трюизму|трюизмы	<font color="#007000">noun</font> трюизм (m) <br>\ntruism
убраться подобру поздорову	save one's bacon, vamoose
углекислота|углекислот|углекислотe|углекислотам|углекислотами|углекислотах|углекислоте|углекислотой|углекислотою|углекислоту|углекислоты	<font color="#007000">noun</font> углекислота (f) <br>\ncarbon dioxide
угловая скорость|угловой скорость	<font color="#007000">noun</font><br>\nangular velocity, rate of change of angular displacement
укладывать(transitive)|укладывав|укладывавшая|укладывавшего|укладывавшее|укладывавшей|укладывавшем|укладывавшему|укладывавши|укладывавшие|укладывавший|укладывавшим|укладывавшими|укладывавших|укладывавшую|укладываема|укладываемая|укладываемо|укладываемого|укладываемое|укладываемой|укладываемом|укладываемому|укладываемую|укладываемы|укладываемые|укладываемый|укладываемым|укладываемыми|укладываемых|укладывающая|укладывающего|укладывающее|укладывающей|укладывающем|укладывающему|укладывающие|укладывающий|укладывающим|укладывающими|укладывающих|укладывающую|укладывая	<font color="#007000">verb</font> укладывать<br>\nlay, lay down, settle, stow, set
укрывать краденное	<font color="#007000">verb</font><br>\nreceive stolen goods
улыбка фортуны|улыбка фортуна	<font color="#007000">noun</font><br>\nsmiles of fortune
униформа|униформ|униформe|униформам|униформами|униформах|униформе|униформой|униформою|униформу|униформы	<font color="#007000">noun</font> униформа (f) <br>\nuniform, distinctive and identifying dress of a particular group (army, police, sports, etc.), official outfit of a certain group
уплетать|уплетаем|уплетает|уплетаете|уплетаешь|уплетай|уплетайте|уплетал|уплетала|уплетали|уплетало|уплетаю|уплетают	<font color="#007000">verb</font><br>\n(Colloquial) tuck into
уползать|уполз|уползаем|уползает|уползаете|уползаешь|уползай|уползайте|уползал|уползала|уползали|уползало|уползаю|уползают|уползем|уползет|уползете|уползешь|уползи|уползите|уползла|уползли|уползло|уползти|уползу|уползут	<font color="#007000">verb</font><br>\n<I>(perf. ><B>уползти</B>)</I> crawl away, creep away
урановая смолка|урановый смолка	<font color="#007000">noun</font><br>\npitchblende
учительский|учительская|учительские|учительским|учительскими|учительских|учительского|учительское|учительской|учительском|учительскому|учительскую	<font color="#007000">adjective</font><br>\nteacher's
футеровать|футеровал|футеровала|футеровали|футеровало|футеруем|футерует|футеруете|футеруешь|футеруй|футеруйте|футерую|футеруют	<font color="#007000">verb</font><br>\nfettle; line
ходить на яхте|ходить на яхта	<font color="#007000">verb</font><br>\nyacht
хозяйствовать(transitive)|хозяйствовав|хозяйствовавшая|хозяйствовавшего|хозяйствовавшее|хозяйствовавшей|хозяйствовавшем|хозяйствовавшему|хозяйствовавши|хозяйствовавшие|хозяйствовавший|хозяйствовавшим|хозяйствовавшими|хозяйствовавших|хозяйствовавшую|хозяйствующая|хозяйствующего|хозяйствующее|хозяйствующей|хозяйствующем|хозяйствующему|хозяйствующие|хозяйствующий|хозяйствующим|хозяйствующими|хозяйствующих|хозяйствующую|хозяйствуя	<font color="#007000">verb</font> хозяйствовать<br>\nkeep house, take care of a home, tend to household chores (i.e. cook, clean, etc.); manage
хоронить(transitive)|хоронив|хоронившая|хоронившего|хоронившее|хоронившей|хоронившем|хоронившему|хоронивши|хоронившие|хоронивший|хоронившим|хоронившими|хоронивших|хоронившую|хороня|хоронящая|хоронящего|хоронящее|хоронящей|хоронящем|хоронящему|хоронящие|хоронящий|хоронящим|хоронящими|хоронящих|хоронящую	<font color="#007000">verb</font> хоронить<br>\n<I>(perf. ><B>захоронить</B>)</I> bury, inter; plant
царить в сердцах|царить в сердце	<font color="#007000">verb</font><br>\nbe enthroned in the hearts
цвета меди|цвет медь	<font color="#007000">adjective</font><br>\ncoppery
цветочный сок	<font color="#007000">noun</font><br>\nnectar
чайная|чайной|чайную|чайные|чайным|чайными|чайных	<font color="#007000">noun</font> чайная (f) <br>\ntea house
человекообразный(transitive)|человекообразен|человекообразна|человекообразно|человекообразны	<font color="#007000">adjective</font> человекообразный<br>\nanthropoid, hominoid, manlike, resembling man
швартов|швартова|швартове|швартову|швартовы|швартовым|швартовыми|швартовых	<font color="#007000">noun</font> швартов (m) <br>\nhawser, cord, heavy rope
шелестеть|шелестел|шелестела|шелестели|шелестело|шелести|шелестим|шелестит|шелестите|шелестишь|шелестят|шелещу	<font color="#007000">verb</font><br>\nrustle, sough; murmur; whisper
шератон|шератона|шератонам|шератонами|шератонах|шератоне|шератонов|шератоном|шератону|шератоны	<font color="#007000">noun</font> шератон (m) <br>\nSheraton (style of furniture)
штука|штук|штукe|штукам|штуками|штуках|штуке|штуки|штукой|штукою|штуку	<font color="#007000">noun</font> штука (f) <br>\npiece
эвфония|эвфонией|эвфониею|эвфонии|эвфоний|эвфонию|эвфониям|эвфониями|эвфониях	<font color="#007000">noun</font> эвфония (f) <br>\neuphony, pleasantness or agreeableness of sounds
экономизм|экономизма|экономизмам|экономизмами|экономизмах|экономизме|экономизмов|экономизмом|экономизму|экономизмы	<font color="#007000">noun</font> экономизм (m) <br>\neconomism
экран|экрана|экранам|экранами|экранах|экране|экранов|экраном|экрану|экраны	<font color="#007000">noun</font> экран (m) <br>\nscreen; shield; shade; display, monitor (Computers)
экстраполяция|экстраполяцией|экстраполяциею|экстраполяции|экстраполяций|экстраполяцию|экстраполяциям|экстраполяциями|экстраполяциях	<font color="#007000">noun</font> экстраполяция (f) <br>\nextrapolation, act of guessing or inferring
это не в его натуре|это не в его натура	it is not in him to do such a thing
явный|явная|явного|явное|явной|явном|явному|явную|явные|явным|явными|явных	<font color="#007000">adjective</font><br>\nevident, clear, obvious, apparent, manifest
ядерная держава|ядерный держава	<font color="#007000">noun</font><br>\nnuclear power, nuclear state
